15 20
1 0

####################

#        ##        #

#        ##        #

#   $    ##    $   #

#        ##        #

#        ##        #

#                  #

#######  *   #######

#                  #

#        ##        #

#        ##        #

#   $    ##    $   #

#        ##        #

#        ##        #

####################